agentPosition=0,1
size=10
2022222222
2100111111
2101022222
2101022222
2101022222
2100000002
2110000002
2011000002
2222211102
0000000000
