agentPosition=8,4
size=10
1112112111
1112112111
0002112000
0002112000
0002112000
0002112000
0222002220
0000000000
0000000000
2221111222
