agentPosition=1,4
size=10
0222222222
0102121112
0102121112
0102121112
0102121112
0102121112
0102121112
0111111112
0111111112
0000000000
