agentPosition=0,4
size=10
1100000011
1100000011
0000000000
0000000000
0000110000
0000110000
0000000000
0000000000
1100000011
1100000011
