agentPosition=0,4
size=10
1120000211
1120000211
2020000202
0000000000
0002112000
0002112000
0000220000
2020000202
1120000211
1120000211
